111111111111111111111
1E00001E00001E0000111
101001110100111010011
101001110100111010011
100000110100111010011
100C00110100111010011
1E00001E00001E0000111
101001110100111010011
101001110100111010011
100000110100111010011
100C00110100111010011
1E00001E00001E0000111
101001110100111010011
101001110100111010011
1000P0110100111010011
100C00110100111010011
1E00001E00001E0000111
101001110100111000011
101001110100111000011
100000110100111000011
111111111111111111111